24 18
132 132 132 132 132 132 132 132 132 132 132 132 132 132 132 132 132 132 132 132 132 132 132 132  
132 132 132 132 132 132 132 170 132 132 132 132 132 132 132 132 132 132 132 132 132 132 132 132
132 132 170 132 132 132 132 132 132 135 135 135 135 135 135 135 135 132 132 132 132 132 170 132  
132 132 132 132 170 132 132 132 132 135 132 132 132 132 132 132 135 170 132 132 132 132 132 132  
132 132 132 132 170 132 132 132 132 135 132 67 132 132 132 132 135 132 170 132 132 132 132 132  
132 132 132 132 132 132 132 132 132 135 132 132 132 132 132 132 135 132 132 132 132 132 132 132  
132 132 132 132 132 135 135 135 135 135 132 132 132 132 86 132 135 132 132 132 132 132 132 132  
132 132 132 132 132 135 141 141 141 141 132 132 132 132 132 132 135 132 132 132 132 132 132 132  
132 132 170 132 132 135 141 4 141 141 132 132 132 132 132 132 135 132 132 132 132 132 132 132  
132 170 132 132 132 135 141 141 141 141 132 132 132 132 132 132 135 132 132 132 132 170 132 132  
132 132 132 132 132 135 135 135 135 135 135 135 135 135 135 135 135 132 132 132 132 132 132 132  
132 132 132 132 132 132 132 132 132 135 132 132 132 132 132 132 135 132 132 132 132 132 132 132  
132 132 132 132 132 132 132 64 132 135 132 25 132 132 132 132 135 132 132 132 132 132 132 132  
132 132 132 132 132 132 132 67 132 135 132 67 132 132 174 132 135 132 132 132 132 132 132 132  
132 132 132 132 170 132 132 77 132 135 132 78 132 132 132 132 135 132 170 132 132 132 132 132  
132 132 132 132 132 132 132 132 132 135 132 132 132 135 135 135 135 170 132 132 132 132 132 132  
132 132 132 132 132 170 132 132 132 135 135 135 135 135 132 132 132 170 132 132 132 132 132 132  
132 132 132 132 132 132 132 132 132 132 132 132 132 132 132 132 132 132 132 132 132 132 132 132  