24 18
132 132 132 132 132 132 132 132 132 132 132 132 132 132 132 132 132 132 132 132 132 132 132 132  
132 132 132 132 132 132 132 141 132 132 132 132 132 132 132 132 132 132 132 132 132 132 132 132
132 132 132 132 132 132 132 132 132 174 174 174 174 174 174 174 174 132 132 132 132 132 141 132  
132 132 132 132 132 132 132 132 132 174 132 132 132 132 132 132 174 141 132 132 132 132 132 132  
132 132 132 132 132 132 132 132 132 174 132 67 132 132 132 132 174 132 141 132 132 132 132 132  
132 132 132 132 132 132 132 132 132 174 132 132 132 132 132 132 174 132 132 132 132 132 132 132  
132 132 132 132 132 174 174 174 174 174 132 132 132 132 86 132 174 132 132 132 132 132 132 132  
132 132 132 132 132 174 170 170 170 170 132 132 132 132 132 132 174 132 132 132 141 132 132 132  
132 141 132 132 132 174 170 25 170 170 132 135 132 132 132 132 174 132 132 132 132 132 132 132  
132 132 141 132 132 174 170 170 170 170 132 132 132 132 132 132 174 132 132 132 132 132 132 132  
132 132 132 132 132 174 174 174 174 174 174 174 174 174 174 174 174 132 132 132 132 132 132 132  
132 132 132 132 132 132 132 132 132 174 132 132 132 132 132 132 174 132 132 132 132 132 132 132  
132 132 132 132 132 132 132 4 132 174 132 64 132 132 132 132 174 132 132 132 132 141 132 132  
132 132 132 132 132 132 132 67 132 174 132 67 132 132 114 132 174 132 132 132 141 141 132 132  
132 132 132 132 132 132 132 77 132 174 132 78 132 132 132 132 174 132 132 132 132 132 132 132  
132 132 141 132 132 132 132 132 132 174 132 132 132 132 132 132 174 132 132 132 132 132 132 132  
132 132 132 132 132 132 132 132 132 174 174 174 174 174 174 174 174 132 132 141 132 132 132 132  
132 132 132 132 132 132 132 132 132 132 132 132 132 132 132 132 132 132 132 132 132 132 132 132  